c1,c2,c3,c4,c5,c6,c7,c8,c9,c10,c11,c12,c13,c14,c15,c16,c17
*,*,*,*,*,*,*,*,*,*,*,*,*,*,*,*,*
*,V,V,V,V,V,V,V,V,V,V,V,V,V,V,V,*
*,V,V,V,V,V,V,V,V,V,V,V,V,V,V,V,*
*,V,V,V,V,V,V,V,V,V,V,V,V,V,V,V,*
*,V,V,V,V,V,V,V,V,V,O,V,V,V,V,V,p
*,V,V,V,V,V,V,V,V,V,V,V,V,V,V,V,*
*,V,V,V,V,V,V,V,V,V,V,V,V,V,V,V,*
*,V,V,V,V,V,V,V,V,V,V,V,V,V,V,V,*
*,*,*,*,*,*,*,*,*,*,*,*,*,*,*,*,*